21121112111000000000000
11111111131111110111113
11111131111111110112111
00111113111111000000000
00011111110004000000000
00040000000004000000000
00040000000004000000000
00211111221111111111100
02111eeee11111111111120
21111111111111111111111
1111311111eeeeeeee11111
1131111111eeeeeeee11112
1111111111eeeeeeee11111
21111111111111111111112
0211eeeeee1111111111120
00211131113111113111200