21121112111000000000000
11111111131111110000000
11111131111111110000000
00111113111111000000000
00011111110004000000000
00040000000004000000000
00040000000004000000000
00211111221111111111100
01111eeee11111111111120
21111111111111111111111
1111311111eeeeeeee11111
1131111111eeeeeeee11112
1111111111eeeeeeee11111
21111111111111111111112
0111eeeeee1111111111110
00211131113111113111200
00011111111111111111000
00001111111111111100000