00000000000000000000000
11111111131111110111113
11111131111111110112111
11111113111111000000000
00040000000004000000000
00000000000004000000000
00040000000004000000000
00000000000000000000000
02111eeee11111111111120
21111111111111111111111
1111311111eeeeeee111111
11311111111111111111112
111111111eeeeee11111111
21111111111111111111112
0211eeeeee1111111111120
11111111111111111111111
11111111111eeeeee111111