11111111111100000000000
11110000031110000000000
11110000001111111300000
00000000011111113100000
0000000021111eee1111000
00000000013111111112100
00000000000040000004000
00000000000040000004000
00000000000040000004000
00000000000040000004000
00000000131111111211100
0000011111eeee111000000
00001112111111100000000
001eeeee111111100000000
11111111000000000000000