211133311111111111111112000000000000000000000000000000000000000000000000000000000
111111111111111111eeeee1111112000000000000000000000000000000000000000000000000000
111111111111111111111111000000000000000000000000000000000000000000000000000000000
000000000000000000004000000000000000000000000000000000000000000000000000000000000
000000000000000000004000000000000000000000000000000000000021111111111112111111200
0000000000000000000040000000000000000000000000000000000001111eeeeee11111113311110
000000000000000000004000000000000000000000000000045555551111111111111111111111111
000000000000000000004000000000000000000000000000040000000111133111111eeeeeee11110
000000000000000000004000000000000000000000000000040000000011111111111111111111100
000000000000000000111111111111211112000000000000040000000000000000000000000000000
000000000000000001111eeee11111111111100000000000040000000000000000000000000000000
000000000000000011111111111111111111115555555555550000000000000000000000000000000
000000000000000001111111111111eeee11100000000000000000000000000000000000000000000
000021111121110000111313111111111111000000000000000000000000000000000000000000000
0001111eeee1111000000000000000000000000000000000000000000000000000000000000000000
002111111111111100000000000000000000000000000000000000000000000000000000000000000
000111111111111000000000000000000000000000000000000000000000000000000000000000000
000011133311110000000000000000000000000000000000000000000000000000000000000000000
000000000000000000000000000000000000000000000000000000000000000000000000000000000