21113331111111111111111200000000000000
111111111111111111eeeee111111200000000
11111111111111111111111100000000000000
00000000000000000000400000000000000000
00000000000000000000400000000000000000
00000000000000000000400000000000000000
00000000000000000000400000000000000000
00000000000000000000400000000000000000
00000000000000000000400000000000000000
00000000000000000011111111111121111200
00000000000000000111116111111111111110
00000000000000001111111111116111111111
00000000000000000111116111111111116110
00002111112111000011131311111111111100
00011111111111100000000000000000000000
00211111111111110000000000000000000000
00011111111111100000000000000000000000
00001113331111000000000000000000000000
00000000000000000000000000000000000000