21113331111111111111111200000000000000
11111111111111111eeeee1111112000000000
11111111111111111111111100000000000000
00000000000000000000400000000000000000
00000000000000000000400000000000000000
00000000000000000000400000000000000000
00000000000000000000400000000000000000
00000000000000000000400000000000000000
00000000000000000000400000000000000000
00000000000000000011111111111121111200
000000000000000001111eeeee111111111110
00000000000000001111111111111111111111
0000000000000000011111111111eeeeee1110
00002111112111000011131311111111111100
000111eee11111100000000000000000000000
002111eee11111110000000000000000000000
000111eee11111100000000000000000000000
00001113331111000000000000000000000000
00000000000000000000000000000000000000