11121100000000000111111000000000000000
111111444444444441eeee1000000000000000
11111100000400000011111000000000000000
00000000000400000000000000000000000000
00000000000400000000000111211100000000
0000000000040000000000011eee1100000000
00000000000444444444444113111100000000
000000000004000000000001eeee1100000000
11111100000400000000000121111100000000
1eee1144444400000000000132111100000000
11111100000400000000000000000000000000
00000000000400000000000000000000000000
00000000000400000000000000000000000000
00000000001110000000000000000000000000
00000000111111100000000000000000000000
000000111eee10311000000000000000000000
00001112311111111110000000000000000000
00111113311111131211100000000000001110
21111111111111111111111000000000001111
11111eeeeeeeeeeeee11111444110011111113
31111111111111131111111000000000001111
00111112331111111121100000000000001110
00002111111111311110000000000000000000
00000011111111111000000000000000000000
00000000111111100000000000000000000000
00000000002110000000000000000000000000