111211000000000002111111100000000000000
111113555554555551eeee11300000000000000
111113000004000000111133100000000000000
000000000004000000000000000000000000000
000000000004000000000003312111000000000
0000000000040000000000031eee11000000000
000000000004555555555551131111000000000
000000000004000000000001eeee11000000000
121113000004000000000001111111000000000
1eee11555554000000000001311112000000000
111113000004000000000000000000000000000
000000000004000000000000000000000000000
000000000004000000000000000000000000000
000000000021100000000000000000000000000
000000001111111000000000000000000000000
000000111eee103110000000000000000000000
000011123111111111100000000000000000000
0011111eeeeeeee112112000000000000021100
112111111111111131111130000000000011111
1111111111161111111111155555005551eee13
131111111111111311111130000000000011111
0011eeee1131111111211000000000000031100
000011111111113111100000000000000000000
000000111eee111110000000000000000000000
000000003311111000000000000000000000000
000000000033300000000000000000000000000