231011000000002111211100006000060000201021011121112000000000000000000000000000002111eeeee112000000
33110100000000311111130006060000600001061113111011100000000000000000000000000000311011111011000000
1111115555555511eeee115555555555555510101111161111100000000000000000000000000000361111111011000000
11101100000000311111110006060000600001060111111011100000000000000000000000000000000002011111000000
231110000000001011311300006000060000101011eeeee111100000000000000000000000000600000061100110000000
00000000000000000000400000000000000000003131111131300000000000000000000002031113121331101101000000
00000000000000000000400000000000000000000000040000000000000000000000000003601161111112116111000000
00000000000000000000400000000000000000000000040000000000000000000000000001111011eeeeeeee1110000000
00000121112000000000400021112111311311111200040000000033112112110000000001110161111111116111000000
0000001111300000000640001313111610161111130004600000003211ee11030000000002311311011011111101000000
00000116111555555555400511011111363111011150045555005511111111110000000000000001101100031031000000
00000111112000000006400013011116101611121100046000000011eeeee1110000000000000000000064600000000000
00000131011000000000400021111111111111111100040000000031111111120000000000000000000004000000000000
000000000000000000004000311eeeeeeeeeeee11200040000000000000000000000000000000000000004000000000000
00000000000000000000460003111111111111113000040000000000000000000000000000000000000004000000000000
00000000020111111210040000000000060000000000040000000000000000000000000000000000000004000000000000
0000000000311eee1160555555511113111012113200040000000000000000000000000000000000000064600000000000
00000000031311111113000000001111121111011300040000000000000000002132311112111112121311112112000000
000000000000000000000000000611eeeeeee1111600046000000000000000061111101111311611111161130311000000
00000000000000000000000000011111060111111300041111116115555555551111111110111111111101111110000000
000000000000000000000000000311eeeeeeee111100000000000000000000061110111111111101111111011110000000
00000000000000000000000000003111131131113000000000000000000000002111111161110111611111111110000000
0000000000000000000000000000000000000000000000000000000000000000033111eeeeeeeeeeeeeeeee11212000000
00000000000000000000000000000600006000060000000000000000000000003011311161113113116131113010000000