111111110000000000
111111111111111101
111111111111111101
000001111110000000
111111111111111101
000000000000000000
000000000000000000
111111111111111111