111111111111111000000000000000000000000000000
000000011111111111111111111111111111111110000
000000000011111111111111111111111111100000000
000111111111111111111111111111111111111111000
000000111111111111111111111111111111111111111
111111111111111111111111111111111100000000000