21121112111000000000000
11111111131111110111111
11111131111111110111111
00111113111111000000000
00011111110004000000000
00040000000004001111111
00040000000004001111111
00040000000004000000000
11111111111111111111111
11111eeee11111111111111
11111111111111111111111
11111111111111eeee11111
11111111111111eeee11111
11111111111111111111111
11111eeeee1111111111111
11111111111111111111111
111111111111111111eeeee