111111110000000000
111111111111111111
000001111111111111
111111111110000000
111111111111111111
111111111111111111
111111111111111111
111111111111111111