111111111110000000
111111111111111101
111111111111111101
001111111111110000
000111111100000011
000000000000000000
111111111100000000
111111111111111111