21121112111000000000000
11111111131111110111111
11111131111111110111111
00111113111111000000000
00011111110004000000000
00040000000004001111111
00040000000004001111111
00040000000004000000000
11111111111111111111111
11111eeee11111111111111
11111111111111111111111
1111111111eeeeeeee11111
1111111111eeeeeeee11111
1111111111eeeeeeee11111
11111111111111111111111
1111eeeeee1111111111111
11111111111111111111111